dungeon_castle
1,10
1,2,3
02 01 01 01 01 01 01 01 01 01 02
02 09 09 09 09 09 09 09 09 09 02
02 09 09 09 09 09 09 09 09 09 02
02 09 09 09 09 09 09 09 09 09 02
02 09 09 09 09 09 09 09 09 09 02
02 09 09 09 09 09 09 09 09 09 02
02 09 09 09 09 09 09 09 09 09 02
02 02 02 02 02 09 02 02 09 02 02
00 00 00 00 02 09 02 02 09 00 02
00 00 00 02 01 09 01 02 09 00 02
00 00 00 02 09 09 09 02 02 02 02
00 00 00 02 09 09 09 02 00 00 00
00 00 00 02 02 02 02 02 00 00 00
