dungeon_castle
1,10
00 00 00 00 00 00 00 00 00 00 00 00 00 00 00 00 02 01 01 01 01 01 01 01 01 02 00 00 00 00 00 00 00 00
00 00 00 00 00 00 00 00 00 00 00 00 00 00 00 00 02 07 07 07 07 07 07 07 07 02 00 00 00 00 00 00 00 00
00 00 00 00 00 00 00 00 00 00 00 00 00 00 00 00 02 07 07 07 07 07 07 07 07 02 00 00 00 00 00 00 00 00
00 00 00 00 00 00 00 00 00 00 00 00 00 00 00 00 02 07 07 07 07 07 07 07 07 02 00 00 00 00 00 00 00 00
00 00 00 00 00 00 00 00 00 00 00 00 00 00 00 00 02 07 07 07 07 07 07 07 07 02 00 00 02 01 01 02 00 00
00 00 00 00 00 00 00 00 00 00 00 00 00 00 00 00 02 07 07 07 07 07 07 07 07 02 00 00 02 05 05 01 01 02
00 00 00 00 00 00 00 00 00 00 02 01 01 01 01 01 01 07 07 07 07 07 07 07 07 01 01 01 01 05 05 00 00 02
00 00 00 00 00 00 00 00 00 05 05 05 05 05 05 07 07 07 07 07 07 07 07 07 07 07 05 05 05 05 05 00 00 02
00 00 00 00 00 00 00 02 01 05 01 02 02 02 02 02 02 07 07 07 07 07 07 07 07 02 02 02 02 05 05 02 02 02
00 00 00 00 00 00 00 02 05 05 05 02 02 00 00 00 02 07 07 07 07 07 07 07 07 02 00 00 02 05 05 02 00 00
00 00 00 00 00 00 00 02 05 02 05 02 00 00 00 00 02 07 07 07 07 07 07 07 07 02 00 00 02 02 02 02 00 00
00 00 00 00 00 00 00 02 05 02 05 02 00 00 00 00 02 07 07 07 07 07 07 07 07 02 00 00 00 00 00 00 00 00
00 00 00 00 00 00 00 02 05 02 05 02 00 00 00 00 02 02 02 02 02 02 02 02 02 02 00 00 00 00 00 00 00 00
00 00 00 00 00 00 02 01 05 02 05 01 02 00 00 00 00 00 00 00 00 00 00 00 00 00 00 00 00 00 00 00 00 00
00 00 00 00 00 02 01 05 05 02 05 05 01 02 00 00 00 00 00 00 00 00 00 00 00 00 00 00 00 00 00 00 00 00
00 00 00 00 02 01 05 05 02 02 02 05 05 01 02 00 00 00 00 00 00 00 00 00 00 00 00 00 00 00 00 00 00 00
02 01 01 01 01 05 05 02 02 02 02 02 05 05 01 01 01 01 02 00 00 00 00 00 00 00 00 00 00 00 00 00 00 00
02 05 05 05 05 05 02 02 00 00 00 02 02 05 05 05 05 05 01 01 01 02 00 00 00 00 00 00 00 00 00 00 00 00
02 05 02 02 02 02 02 00 00 00 00 00 02 02 02 02 02 05 05 05 05 02 00 00 00 00 00 00 00 00 00 00 00 00
02 05 01 02 00 02 01 01 01 01 01 01 02 00 00 02 01 05 02 02 05 02 00 00 00 00 00 00 00 00 00 00 00 00
02 05 05 01 02 02 05 05 05 05 05 05 02 00 02 01 05 05 02 02 05 02 00 00 00 00 00 00 00 00 00 00 00 00
02 02 05 05 01 02 05 05 05 05 05 05 02 02 01 05 05 02 01 01 05 01 01 02 00 00 00 00 00 00 00 00 00 00
00 02 02 05 05 01 02 02 05 05 02 02 02 01 05 05 02 02 05 05 05 05 05 02 00 00 00 00 00 00 00 00 00 00
00 00 02 02 05 05 01 01 05 05 01 01 01 05 05 02 02 02 05 05 05 05 05 02 00 00 00 00 00 00 00 00 00 00
00 00 00 02 02 05 05 05 05 05 05 05 05 05 02 02 00 02 02 02 02 02 02 02 00 00 00 00 00 00 00 00 00 00
00 00 00 00 02 02 02 02 02 05 05 02 02 02 02 00 00 00 00 00 00 00 00 00 00 00 00 00 00 00 00 00 00 00
00 00 00 00 00 00 00 00 02 05 05 02 00 00 00 00 00 00 00 00 00 00 00 00 00 00 00 00 00 00 00 00 00 00
00 00 00 00 00 00 00 02 01 05 05 01 02 00 00 00 00 00 00 00 00 00 00 00 00 00 00 00 00 00 00 00 00 00
00 00 00 00 00 00 00 02 05 05 05 05 02 00 00 00 00 00 00 00 00 00 00 00 00 00 00 00 00 00 00 00 00 00
00 00 00 00 00 00 00 02 05 05 05 05 02 00 00 00 00 00 00 00 00 00 00 00 00 00 00 00 00 00 00 00 00 00
