dungeon_castle
1,10
1,2,3
00 00 00 00 00 00 00 00 00 00 02 01 01 01 01 01 01 01 01 02 00 00 00 00 00 00 00 00 00 00 00 00 00 00 00 00
00 00 00 00 00 00 00 00 00 00 02 09 09 09 09 09 09 09 09 02 00 00 00 00 00 00 00 00 00 00 00 00 00 00 00 00
00 00 00 00 00 00 00 00 00 00 02 09 09 09 09 09 09 09 09 02 00 00 00 00 00 00 00 00 00 00 00 00 00 00 00 00
00 00 00 00 00 00 00 00 00 00 02 02 02 02 09 09 02 02 02 02 00 00 00 00 00 00 00 00 00 00 00 00 00 00 00 00
00 00 00 00 00 00 00 00 00 00 00 00 00 02 09 09 02 00 00 00 00 00 00 00 00 00 00 00 00 00 00 00 00 00 00 00
00 00 00 00 00 00 00 00 00 00 02 01 01 01 09 09 01 01 01 02 00 00 00 00 00 00 00 00 00 00 00 00 00 00 00 00
00 00 00 00 00 00 00 00 00 00 02 09 09 09 09 09 09 09 09 02 00 00 00 00 00 00 00 00 00 02 01 02 00 00 00 00
00 00 00 00 00 00 00 02 01 01 01 09 09 09 09 09 09 09 09 01 01 01 02 00 00 00 00 00 00 02 00 01 01 01 02 00
00 00 00 00 00 00 00 02 09 09 09 09 09 09 09 09 09 09 09 09 09 09 02 00 00 00 00 00 00 02 00 09 09 09 02 00
00 00 00 00 00 00 00 02 09 09 09 09 09 09 09 09 09 09 09 09 09 09 02 00 00 00 00 00 00 02 00 02 02 09 02 00
00 00 00 00 00 00 00 02 09 09 09 09 09 09 09 09 09 09 09 09 09 09 02 00 00 00 00 00 00 02 02 02 02 09 01 02
00 00 00 00 00 00 00 02 09 09 09 09 09 09 09 09 09 09 09 09 09 09 02 00 00 00 00 00 00 00 00 00 02 09 09 02
00 00 00 00 00 00 00 02 02 02 02 09 09 09 09 09 09 09 09 02 02 02 02 00 00 00 00 00 00 00 02 01 01 09 09 02
00 00 00 00 00 00 00 00 00 00 02 09 09 09 09 09 09 09 09 02 00 00 00 00 00 00 00 00 00 00 02 09 09 09 09 02
02 01 01 01 01 02 00 00 00 00 02 02 02 02 09 09 02 02 02 02 00 00 00 00 00 00 00 00 02 01 01 09 09 09 09 02
02 09 09 09 09 02 00 00 00 00 00 00 00 02 09 09 02 00 00 00 00 00 00 00 00 00 00 00 02 09 09 09 09 09 09 02
02 09 09 09 09 02 00 00 00 00 00 00 00 02 09 09 02 02 01 01 01 01 01 01 01 01 01 01 01 09 09 09 09 09 09 02
02 09 09 09 09 01 01 02 00 00 00 00 00 02 09 09 02 02 09 09 09 09 09 09 09 09 09 09 09 09 09 09 09 09 09 02
02 02 09 09 09 09 09 01 01 01 01 01 01 01 09 09 01 01 09 09 09 09 09 09 09 09 09 09 09 09 09 09 09 09 09 02
00 02 02 02 02 02 09 09 09 09 09 09 09 09 09 09 09 09 09 09 02 02 02 02 09 09 02 02 02 02 02 02 02 02 02 02
00 02 01 01 01 01 09 09 09 09 09 09 09 09 09 09 09 09 09 09 02 00 02 01 09 09 02 00 00 00 02 01 01 01 02 00
02 01 09 09 09 09 09 02 02 02 02 02 02 02 09 09 02 02 02 02 02 00 02 09 09 09 02 00 00 00 02 09 09 09 02 00
02 09 09 09 09 02 02 02 00 00 00 00 00 02 09 09 02 00 00 00 00 02 01 09 02 09 02 00 00 00 02 09 09 09 02 00
02 09 09 09 09 02 00 00 00 00 00 00 00 02 09 09 02 00 00 00 00 02 09 09 02 09 01 01 01 01 01 09 09 09 02 00
02 09 09 09 09 02 00 02 01 01 01 01 01 01 09 09 02 00 00 00 00 02 09 02 02 09 09 09 09 09 09 09 09 09 02 00
02 02 02 02 02 02 00 02 09 09 09 09 09 09 09 09 02 00 00 00 00 02 09 02 02 02 02 02 02 02 02 09 09 09 02 00
00 00 00 00 00 00 00 02 09 02 02 02 02 02 02 02 02 00 00 00 00 02 09 02 00 00 00 00 00 00 02 09 09 09 02 00
00 00 00 00 00 00 00 02 09 02 00 00 00 00 00 00 00 00 00 02 01 01 09 01 01 02 00 00 00 00 02 09 09 09 02 00
00 00 00 00 00 00 02 01 09 01 02 00 00 00 00 00 00 00 00 02 09 09 09 09 09 02 00 00 00 00 02 02 02 02 02 00
00 00 00 00 00 00 02 09 09 09 02 00 00 00 00 00 00 00 00 02 09 09 09 09 09 02 00 00 00 00 00 00 00 00 00 00
00 00 00 00 00 00 02 09 09 09 02 00 00 00 00 00 00 00 00 02 09 09 09 09 09 02 00 00 00 00 00 00 00 00 00 00
00 00 00 00 00 00 02 02 02 02 02 00 00 00 00 00 00 00 00 02 02 02 02 02 02 02 00 00 00 00 00 00 00 00 00 00
