00 00 00 00 00 00 02 01 01 02 00 00 00 00 00 00 00 00 00 00 00 00 00 00
00 00 00 00 00 00 02 08 08 01 01 02 00 00 00 00 00 00 00 00 00 00 00 00
00 00 00 00 00 02 01 08 08 08 08 01 01 02 00 00 00 00 00 00 00 00 00 00
00 00 00 00 00 02 08 08 08 08 08 08 08 02 00 00 00 00 00 00 00 00 00 00
00 00 00 00 02 01 08 08 08 08 08 08 08 02 00 00 00 00 00 00 00 00 00 00
00 00 00 00 02 08 08 08 08 08 08 08 08 02 00 00 00 00 00 00 00 00 00 00
00 00 00 00 02 08 08 08 08 08 08 08 08 02 00 00 00 00 00 00 00 00 00 00
00 00 00 00 02 02 08 08 08 08 08 02 02 02 00 00 00 00 00 00 00 00 00 00
00 00 00 00 00 02 08 08 08 02 02 02 00 00 00 00 00 00 00 00 00 00 00 00
00 00 00 00 00 02 02 08 02 02 02 01 02 00 00 00 00 00 00 00 00 00 00 00
00 00 00 00 00 00 02 08 01 01 01 08 01 01 01 02 00 00 02 01 01 02 00 00
00 00 00 00 00 00 02 08 08 08 08 08 08 08 08 01 02 00 02 08 08 02 00 00
00 00 00 02 01 01 01 01 01 08 02 08 02 02 08 08 01 02 02 08 08 01 01 02
02 01 01 01 08 08 08 08 08 08 02 08 02 02 02 08 08 01 01 08 08 00 00 02
02 08 08 08 08 08 08 08 02 02 02 08 02 00 02 02 08 08 08 08 08 00 00 02
02 08 02 02 08 08 08 08 02 02 01 08 02 00 00 02 02 02 02 08 08 02 02 02
02 08 01 01 02 08 08 08 02 01 08 08 02 00 00 00 00 00 02 08 08 02 00 00
02 08 08 08 02 02 02 02 01 08 08 02 02 00 00 00 00 00 02 08 08 02 00 00
02 02 02 08 01 01 01 01 08 08 02 02 00 00 00 00 00 00 02 02 02 02 00 00
00 00 02 08 08 08 08 08 08 02 02 00 00 00 00 00 00 00 00 00 00 00 00 00
00 00 02 02 02 02 08 02 02 02 00 00 00 00 00 00 00 00 00 00 00 00 00 00
00 00 00 02 01 01 08 02 00 00 00 00 00 00 00 00 00 00 00 00 00 00 00 00
00 00 00 02 08 08 08 02 00 00 00 00 00 00 00 00 00 00 00 00 00 00 00 00
00 00 00 02 08 02 02 02 00 00 00 00 00 00 00 00 00 00 00 00 00 00 00 00
00 00 00 02 08 02 00 00 00 00 00 00 00 00 00 00 00 00 00 00 00 00 00 00
00 00 00 02 08 02 00 00 00 00 00 00 00 00 00 00 00 00 00 00 00 00 00 00
00 00 00 02 08 02 00 00 00 00 00 00 00 00 00 00 00 00 00 00 00 00 00 00
00 00 02 01 08 01 02 00 00 00 00 00 00 00 00 00 00 00 00 00 00 00 00 00
00 00 02 08 08 08 02 00 00 00 00 00 00 00 00 00 00 00 00 00 00 00 00 00
00 00 02 08 08 08 02 00 00 00 00 00 00 00 00 00 00 00 00 00 00 00 00 00