dungeon_castle
1,10
1,2,3
00 00 00 00 00 01 01 01 03 01 00 00 00 00 00 00 00 00 00 00 00 00 00 00 00 00 00 00 00 00 00 00 00 00 00 00 00
00 00 00 00 02 02 06 06 06 02 02 00 00 00 00 00 00 00 00 00 00 00 00 00 00 00 00 00 00 00 00 00 00 00 00 00 00
00 00 00 00 02 06 06 06 06 06 02 00 00 00 00 00 00 00 00 00 00 00 00 00 00 00 00 00 00 00 00 00 00 00 00 00 00
00 00 00 00 02 06 06 06 06 06 02 00 00 00 00 00 00 00 00 00 00 00 00 00 00 00 00 00 00 00 00 00 00 00 00 00 00
00 00 02 01 01 01 01 01 01 06 02 00 00 00 00 00 00 00 00 00 00 00 00 00 00 00 00 00 00 00 00 00 00 00 00 00 00
00 02 01 06 06 06 06 06 01 06 02 00 00 00 00 00 00 00 00 00 00 00 00 00 00 00 00 00 00 00 00 00 00 00 00 00 00
02 01 06 06 06 06 06 06 06 06 02 00 00 00 00 00 00 00 00 00 00 00 00 00 00 00 00 00 00 00 00 00 00 00 00 00 00
02 06 06 06 06 06 06 06 06 01 01 01 01 01 01 01 02 00 02 01 01 02 00 00 00 00 02 01 01 01 01 01 00 00 01 01 02
02 06 06 06 06 06 06 06 06 06 06 06 06 06 06 06 02 02 01 06 06 01 02 00 00 00 02 06 06 06 06 06 06 06 06 06 02 
02 02 06 06 06 06 06 06 06 02 02 02 02 02 02 06 02 02 06 06 06 06 02 00 00 00 02 06 06 06 06 06 06 06 06 06 02
00 02 02 06 06 06 06 06 02 00 00 00 00 00 02 06 01 01 06 06 06 06 02 01 01 01 02 06 06 06 06 06 06 06 06 06 02
00 00 02 02 02 06 02 02 02 00 00 00 00 00 02 06 06 06 06 06 06 06 02 06 06 06 02 02 02 02 02 06 02 02 02 02 02
00 00 00 02 01 06 02 00 00 00 00 00 00 00 02 02 02 02 02 06 02 02 02 06 06 06 02 00 02 01 06 06 02 00 00 00 00
00 00 02 01 06 06 02 00 00 00 00 00 00 00 00 00 00 00 02 06 06 06 06 06 06 06 02 02 01 06 06 02 02 00 00 00 00
00 00 02 06 06 02 02 00 00 00 00 00 00 00 00 00 00 00 02 02 02 02 02 06 06 06 01 01 06 06 02 02 00 00 00 00 00
00 00 02 06 02 02 00 00 00 00 00 00 00 00 00 00 00 00 00 00 00 00 02 06 06 06 06 06 06 02 02 00 00 00 00 00 00
00 00 02 06 02 00 00 00 00 00 00 00 00 00 00 00 00 00 00 00 00 00 02 02 02 02 02 02 02 02 00 00 00 00 00 00 00
00 02 01 06 01 02 00 00 00 00 00 00 00 00 00 00 00 00 00 00 00 00 00 00 00 00 00 00 00 00 00 00 00 00 00 00 00
00 02 06 06 06 02 00 00 00 00 00 00 00 00 00 00 00 00 00 00 00 00 00 00 00 00 00 00 00 00 00 00 00 00 00 00 00
00 02 06 06 06 02 00 00 00 00 00 00 00 00 00 00 00 00 00 00 00 00 00 00 00 00 00 00 00 00 00 00 00 00 00 00 00

