dungeon_castle
1,10
1,2,3
00 02 01 01 01 02 00 00 00 00 00 00 00 00 00 00 00 00 00 00 00 00 00 00 00 00 00 00 00 00 00 00 00 00 00 00 00 00 00
00 02 05 05 05 02 00 00 00 00 00 00 00 00 00 00 00 00 00 00 00 00 00 00 00 00 00 00 00 00 00 00 00 00 00 00 00 00 00
00 02 05 05 05 02 00 00 00 00 00 00 00 00 00 00 00 00 00 00 00 00 00 00 00 00 00 00 00 00 00 00 00 00 00 00 00 00 00
00 02 05 05 05 02 00 00 00 00 00 00 00 00 00 00 00 00 00 00 00 00 00 00 00 00 00 00 00 00 00 00 00 00 00 00 00 00 00
00 02 02 05 02 02 00 00 00 00 00 00 00 00 00 00 02 01 01 02 00 00 00 00 00 00 00 00 00 00 00 00 00 00 00 00 00 00 00
00 00 02 05 02 00 00 00 00 00 00 00 00 00 00 02 01 05 05 01 02 00 00 00 00 00 00 00 00 00 00 00 00 00 00 00 00 00 00
00 00 02 05 02 00 00 00 00 00 00 00 00 00 02 01 05 05 05 05 01 02 00 00 00 00 00 00 00 00 00 00 00 00 00 00 00 00 00
00 00 02 05 02 00 00 00 00 00 00 00 00 02 01 05 05 05 05 05 05 01 02 00 00 00 00 00 00 00 02 01 01 01 01 02 00 00 00
00 00 02 05 02 00 00 00 00 00 00 00 02 01 05 05 05 05 05 05 05 05 01 02 00 00 00 00 00 00 02 05 05 05 05 01 01 02 00
00 00 02 05 02 00 00 00 00 02 01 01 01 05 05 05 05 05 05 05 05 05 05 02 00 00 00 02 01 01 01 05 05 05 05 00 00 02 00
00 00 02 05 02 00 00 00 00 02 05 05 05 05 05 05 05 05 05 05 05 05 05 02 00 00 00 02 05 05 05 05 05 05 05 00 00 02 00
02 01 01 05 01 01 02 00 00 02 05 02 02 05 05 05 05 05 05 05 05 05 05 02 01 01 01 01 05 02 02 05 05 05 05 02 02 02 00
02 05 05 05 05 05 02 00 00 02 05 02 02 02 05 05 05 05 05 05 05 05 05 02 05 05 05 05 05 02 02 05 05 05 05 00 00 00 00
02 05 05 05 05 05 02 00 00 02 05 01 01 01 01 01 01 01 02 02 02 02 05 02 05 02 02 02 02 02 01 01 01 01 01 01 01 01 02
02 05 05 05 05 05 02 00 00 02 05 05 05 05 05 05 05 05 02 00 00 02 05 01 05 01 01 01 01 01 05 05 05 05 05 05 00 00 02
02 02 02 02 05 01 02 00 00 02 02 02 05 05 05 02 02 05 02 00 00 02 05 05 05 05 05 05 05 05 05 05 05 05 05 05 00 00 02
00 00 00 02 05 05 01 02 00 00 00 02 05 05 05 02 02 05 02 00 00 02 02 02 05 02 02 02 02 02 05 05 05 05 05 05 00 00 02
00 00 00 02 02 05 05 01 01 01 01 01 01 01 01 01 01 05 02 00 00 00 00 02 05 01 01 01 01 02 01 01 01 01 01 02 02 02 02
00 00 00 00 02 02 05 05 05 05 05 05 05 05 05 05 05 05 02 00 00 00 00 02 05 05 05 05 05 02 05 05 05 05 05 02 00 00 00
00 00 00 00 00 02 02 02 02 02 02 02 02 05 02 02 02 02 02 00 00 00 00 02 02 02 02 02 05 01 05 05 05 05 05 01 01 02 00
00 00 00 00 00 00 00 00 00 00 00 00 02 05 02 00 00 00 00 00 00 00 00 00 00 00 00 02 05 05 05 05 05 05 05 00 00 02 00
00 00 00 00 00 00 00 00 00 00 00 00 02 05 02 00 00 00 00 00 00 00 00 00 00 00 00 02 02 02 05 05 05 05 05 00 00 02 00
00 00 00 00 00 00 00 00 00 00 00 00 00 05 02 00 00 00 00 00 00 00 00 00 00 00 00 00 00 02 05 05 05 05 05 02 02 02 00
00 00 00 00 00 02 05 05 05 05 05 05 05 05 02 00 00 00 00 00 00 00 00 00 00 00 00 00 00 02 02 02 02 02 02 02 00 00 00
00 00 00 00 02 01 05 01 02 02 02 02 02 02 02 00 00 00 00 00 00 00 00 00 00 00 00 00 00 00 00 00 00 00 00 00 00 00 00
00 00 00 00 02 05 05 05 02 00 00 00 00 00 00 00 00 00 00 00 00 00 00 00 00 00 00 00 00 00 00 00 00 00 00 00 00 00 00
00 00 00 00 02 05 05 05 02 00 00 00 00 00 00 00 00 00 00 00 00 00 00 00 00 00 00 00 00 00 00 00 00 00 00 00 00 00 00
