dungeon_castle
1,10
1,2,3
2070,2610
00 00 00 00 00 02 01 01 01 01 01 01 01 01 01 01 01 02 00 00 00 00 00
00 00 00 00 00 02 09 09 09 09 09 09 09 09 09 09 09 02 00 00 00 00 00
02 01 01 01 01 01 08 01 01 01 01 02 01 01 01 01 09 01 01 01 01 01 02
02 07 07 07 07 07 07 07 07 07 07 02 02 00 02 09 09 09 09 09 09 09 02
02 07 07 07 07 07 07 07 07 07 07 02 02 00 02 09 09 09 09 09 09 09 02
02 07 07 07 07 07 07 07 07 07 07 02 02 00 02 09 09 09 09 09 09 09 02
02 07 07 07 07 07 07 07 07 07 07 02 02 00 02 09 09 09 09 09 09 09 02
02 07 07 07 07 07 07 07 07 07 07 02 02 00 02 09 09 09 09 09 09 09 02
02 07 07 07 07 07 07 07 07 07 07 02 02 00 02 09 09 09 09 09 09 09 02
02 07 07 07 07 07 07 07 07 07 07 02 02 00 02 09 09 09 09 09 09 09 02
02 07 07 07 07 07 07 07 07 07 07 02 02 00 02 09 09 09 09 09 09 09 02
02 07 07 07 07 07 07 07 07 07 07 02 02 00 02 09 09 09 09 09 09 09 02
02 07 07 07 07 07 07 07 07 07 07 02 02 00 02 09 09 09 09 09 09 09 02
02 02 02 02 02 02 02 02 02 02 06 02 02 02 02 02 02 02 02 02 02 02 02
00 00 00 00 00 00 00 00 00 00 06 06 02 00 00 00 00 00 00 00 00 00 00
00 00 00 00 00 00 00 00 00 00 06 06 02 00 00 00 00 00 00 00 00 00 00
00 00 00 00 00 00 00 00 00 00 06 06 02 00 00 00 00 00 00 00 00 00 00
00 00 00 00 00 00 00 00 00 00 06 06 02 00 00 00 00 00 00 00 00 00 00
00 00 00 02 01 01 01 01 01 01 06 06 02 00 00 00 00 00 00 00 00 00 00
00 00 02 01 06 06 06 06 06 06 06 06 02 00 00 00 00 00 00 00 00 00 00
00 00 02 06 06 02 02 02 02 02 02 02 02 00 00 00 00 00 00 00 00 00 00
00 00 02 06 06 02 00 00 00 00 00 00 00 00 00 00 00 00 00 00 00 00 00
00 00 02 06 06 02 00 00 00 00 00 00 00 00 00 00 00 00 00 00 00 00 00
00 00 02 06 06 02 00 00 00 00 00 00 00 00 00 00 00 00 00 00 00 00 00
00 00 02 06 06 02 00 00 00 00 00 00 00 00 00 00 00 00 00 00 00 00 00
00 02 01 06 06 02 02 00 00 00 00 00 00 00 00 00 00 00 00 00 00 00 00
00 02 06 06 06 06 02 00 00 00 00 00 00 00 00 00 00 00 00 00 00 00 00
00 02 06 06 06 06 02 00 00 00 00 00 00 00 00 00 00 00 00 00 00 00 00
00 02 06 06 06 06 02 00 00 00 00 00 00 00 00 00 00 00 00 00 00 00 00
