town
4,10
5,7,12,13,14,15,16,18,19,20,21,22,23,24,25,26,27,28,29
2340,810,Castle1.txt,2070,180:2340,1350,Dungeon1.txt,720,810:
1
2700,1530
00 22 21 21 21 22 01 27 28 01 00 21 21 28 27 02 22 21 21 21 22 03 21 21 28 27 00 27 28 01
01 15 30 30 31 15 02 15 10 29 02 01 10 10 15 01 15 30 30 31 15 02 01 10 10 15 01 15 10 29
02 15 30 31 30 15 03 15 10 15 01 29 10 10 15 00 15 31 30 30 15 01 29 10 10 15 02 15 10 15
03 16 16 09 16 16 04 16 09 16 03 24 23 09 16 02 16 16 09 16 16 02 24 23 09 16 03 16 09 16
04 02 01 09 09 09 09 09 09 09 09 09 09 09 09 09 09 09 09 09 09 09 09 09 09 09 09 09 09 03
02 01 22 09 10 02 22 09 10 01 02 09 22 01 22 09 22 01 09 01 02 09 22 01 02 03 04 00 01 02
00 01 15 10 10 01 15 10 10 00 29 10 15 02 15 10 15 02 09 00 29 10 15 08 08 08 08 08 08 08
01 02 20 25 25 02 20 25 26 01 20 25 20 03 20 09 20 03 09 02 20 25 20 08 13 12 12 12 14 08
00 01 02 03 04 01 00 02 03 01 02 03 04 01 02 00 03 04 09 01 02 00 01 08 20 20 20 20 20 08
05 05 05 05 05 05 05 05 05 05 05 05 02 22 21 22 01 00 09 02 00 01 03 08 20 20 11 20 20 08
00 01 02 03 04 02 03 02 01 05 05 05 01 15 10 15 02 01 09 01 22 21 22 08 08 08 09 08 08 08
01 09 09 09 09 09 09 09 09 01 03 02 00 20 09 20 05 05 09 02 15 10 15 08 08 08 09 08 08 08
02 09 07 07 07 07 07 07 09 00 01 02 03 04 09 01 06 06 09 00 20 09 20 08 08 08 09 08 08 08
04 09 07 07 07 07 07 07 09 09 09 09 09 09 09 09 09 09 09 09 09 09 09 09 09 09 09 08 08 08
03 09 07 07 07 07 07 07 09 06 06 06 06 06 06 06 06 06 06 06 00 02 09 00 01 17 09 17 06 06
02 09 09 09 09 09 09 09 09 01 03 00 06 06 06 06 06 06 06 06 01 32 31 33 00 17 11 17 06 06
00 01 02 03 04 00 01 02 00 01 04 03 02 00 02 03 01 00 02 01 00 19 19 18 01 12 12 12 00 01
